################################
#                             r#
#   p  w     h     w           #
#      w     h     w           #
#      w     h     w         r #
#      w     h     w           #
#                        s     #
#                      r       #
################################