################################
#                              #
#   p  w     h     w           #
#      w     h  r  w           #
#      w     h     w         r #
#      w     h     w           #
#                        s     #
#                      r       #
################################