################################
#                              #
#      b                r      #
# r    ww              ww    r #
#      w        p      sw      #
# b    ww              ww    r #
#                              #
#                       b      #
################################