################################
#           hhhhhhh            #
#       hhhh       hhhh        #
#      ww              ww    r #
#      w        p       w      #
#r     ww              ww    r #
#        hhh s      hhh        #
#           hhhhhhhh           #
################################