################################
#           hhhhhhh            #
#       hhhh       hhhh        #
#r     ww              ww    r #
#      h        p       h      #
#r     ww              ww    r #
#        hhh s      hhh        #
#           hhhhhhhh           #
################################