################################
#  p s  w                w     #
#       w c  h   w       w  r  #
#       w    w   w       w     #
#www    w c  w r w       h b b #
#       w    wwwww b b b h     #
#       w  b     w             #
#b               w  b b b    r #
################################