################################
#                         r    #
#      wwwwwwwwwwwwww          #
#                              #
#            p                 #
#      wwwwwwwwwwwwww          #
#                       r      #
#             r                #
################################