################################
#  p s  w                w     #
#       w c      w       w  r  #
#       w        w       w     #
#www    w c    r w       h b b #
#       w    wwwww b b b h     #
#          b     h             #
#b               h  b b b    r #
################################