################################
#    w               r       b #
# r        w   e     w         #
#    w                         #
#w         wwww                #
#                 w     b      #
#      s        b  w      w    #
#  p      w                  b #
################################