################################
#                              #
#   p  w     h     w           #
#      w     h  b  w           #
#      w     h     w      s    #
#      w     h     w           #
#                              #
#                       b      #
################################