################################
#           hhhhhhh            #
#       hhhh       hhhh        #
#r     ww              ww      #
#      h        p       h      #
#      ww              ww    r #
#        hhh s      hhh        #
#           hhhhhhhh           #
################################