################################
#    w               r       b #
#  b       w         w         #
#    w                         #
#w         wwww                #
#                 w            #
#      s        b  w      w    #
#  p      w                  b #
################################