#################################
#				                        #
#  p   w    sss	   w	          #
#      w    sss    w	          #
#      w    sss	   w	e	        #
#      w	         w		        #
#		e		                        #
#			       	                  #
#################################