################################
#    w               e       e #
# e        w   e     w         #
#    w                         #
#w         wwww                #
#                 w     e      #
#      s        e  w      w    #
#  p      w                  e #
################################