################################
#                              #
#   b                          #
#              p               #
#                              #
#                              #
#                              #
#                              #
################################