################################
#                             e#
#   p  w     h     w           #
#      w     h     w           #
#      w     h     w         e #
#      w     h     w           #
#                        s     #
#                      e       #
################################