################################
#                             e#
#   p  w    hhh    w           #
#      w    hhh    w           #
#      w    hhh    w         e #
#      w           w           #
#                        s     #
#                      e       #
################################