################################
#           hhhhhhh            #
#       hhhh       hhhh        #
#e     ww              ww    e #
#      w        p       w      #
#e     ww              ww    e #
#        hhh s      hhh        #
#           hhhhhhhh           #
################################