################################
#                             e#
#   p  w    hhh    w           #
#      w    hhh    w           #
#  s   w    hhh    w         e #
#      w           w           #
#                        s     #
#                      e       #
################################