################################
#                              #
#      e                e      #
#e     ww              ww    e #
#      w        p      sw      #
#e     ww              ww    e #
#                       e      #
#                              #
################################