################################
#           hhhhhhh            #
#       hhhh       hhhh        #
#e     ww              ww    e #
#      h        p       h      #
#e     ww              ww    e #
#        hhh s      hhh        #
#           hhhhhhhh           #
################################