################################
#                              #
#                              #
#      ww              ww      #
#      w        p      sw    c #
#      ww              ww      #
#  c                           #
#                        c     #
################################