################################
#                      e       #
#      wwwwwwwwwwwwww          #
#                              #
#            p                 #
#      wwwwwwwwwwwwww          #
#                       e      #
#             e                #
################################