################################
#                              #
#   p  w     h     w           #
#      w     h  b  w           #
#      w     h     w         b #
#      w     h     w           #
#                        s     #
#                      r       #
################################