################################
#        b             b       #
#      wwwwwwwwwwwwww          #
#                              #
#            p                 #
#      wwwwwwwwwwwwww          #
#                              #
#             r                #
################################