################################
#  c    s     w     r          #
#       w     wwww          r  #
#             w                #
# c   w          b     www     #
#wwwwww       w        www     #
#             wwww          r  #
#  p          w     r          #
################################