################################
#                           s  #
#   b                          #
#              p               #
#                              #
#                          h   #
#      w                       #
#                              #
################################