################################
#                              #
#   p  w     h     w           #
#      w     h  c  w           #
#      w     h     w           #
#      w     h     w           #
#                        s     #
#  c                    c      #
################################