################################
#  c                       w c #
#                          w   #
#           w     w            #
#              p               #
#           w     w            #
#    w         b               #
#  c w                      c  #
################################